107
8
21,12,12,12,13,0,0,0,0,0,0,0,0,0,0,0,0,0,0,0,0,0,0,0,0,0,0,21,6,15,13,0,0,0,0,0,0,0,0,0,0,0,0,0,0,0,0,0,1,2,3,0,0,0,0,0,0,0,0,0,0,0,0,0,0,0,0,0,0,0,0,0,0,0,0,0,0,0,55,0,0,0,0,0,0,0,0,0,0,0,0,0,0,0,0,0,0,55,0,0,0,0,0,0,0,0,0,
0,21,22,22,23,0,0,0,0,0,0,0,0,0,0,0,0,0,1,2,2,2,48,0,0,0,0,0,21,6,15,3,0,0,0,0,39,0,7,59,0,0,0,0,0,0,0,47,26,12,24,48,0,0,0,0,0,0,32,33,33,33,34,0,0,0,0,0,0,0,0,0,0,0,0,0,0,0,55,0,0,0,0,0,0,0,39,0,39,0,39,0,0,0,0,0,0,55,0,0,0,0,0,0,39,0,0,
0,0,0,0,0,0,0,0,0,0,0,0,7,59,0,0,47,2,15,20,30,40,58,2,2,48,0,0,0,21,22,23,0,0,0,1,20,30,30,50,3,0,0,0,0,0,0,21,22,22,22,23,0,0,0,39,39,0,0,0,0,0,0,0,39,0,0,0,0,0,0,0,0,0,0,0,0,0,56,0,0,0,0,7,1,20,40,60,40,40,50,3,0,0,0,0,0,55,0,0,0,0,0,39,0,39,0,
0,0,0,0,0,0,39,0,0,0,0,39,0,0,7,59,21,22,22,22,22,22,22,22,22,23,0,0,0,0,0,0,0,0,32,5,22,22,22,22,22,34,0,0,0,0,0,0,0,0,0,0,0,0,39,0,0,0,0,0,0,0,0,39,0,0,39,0,0,0,39,0,39,0,39,0,0,0,0,0,0,0,39,0,21,22,22,22,22,22,22,23,0,0,0,0,0,56,0,0,0,0,39,0,0,0,0,
0,0,0,0,0,0,0,0,0,39,0,0,0,0,0,0,0,0,0,0,0,0,0,0,0,0,0,0,0,0,0,0,0,0,0,0,0,0,0,0,0,0,0,0,0,0,32,33,33,33,33,33,33,34,0,0,1,2,3,0,0,0,39,47,2,48,0,0,0,39,0,39,0,39,0,7,59,0,0,0,0,39,0,0,0,0,0,0,0,0,0,0,0,0,0,0,0,0,0,0,0,39,0,47,3,0,0,
0,0,0,0,1,3,0,32,34,0,31,0,32,33,33,34,0,0,0,0,0,0,0,0,0,0,0,0,0,0,0,1,48,47,48,0,0,0,0,0,0,47,2,3,0,0,0,0,0,0,0,0,0,0,0,0,11,12,58,3,0,39,0,11,12,13,0,7,59,0,0,0,0,0,0,0,0,39,0,0,39,0,0,0,0,0,0,0,0,0,0,0,0,0,0,0,0,0,0,0,39,0,47,57,13,0,39,
0,0,1,2,57,13,0,0,0,0,0,0,39,0,0,0,0,0,0,39,0,39,0,39,0,39,0,0,0,1,2,57,13,21,23,39,0,39,0,39,0,11,12,58,3,0,0,0,0,0,0,0,0,0,0,0,11,12,12,58,3,0,0,11,12,58,48,0,0,0,0,0,0,0,0,0,0,0,0,39,0,0,0,47,2,2,2,2,48,0,0,0,49,9,0,7,59,0,0,0,0,47,57,12,13,0,0,
32,12,12,12,12,20,30,30,30,30,30,30,30,50,2,2,2,2,20,30,60,30,60,30,60,30,50,2,2,57,12,12,12,12,20,40,40,40,40,40,50,57,12,12,58,20,40,40,40,40,40,40,40,40,40,50,57,12,12,12,58,20,50,57,12,12,58,2,20,40,40,40,40,40,40,40,40,50,2,2,2,2,2,57,15,15,15,15,58,2,2,2,20,30,30,30,50,2,2,2,2,57,12,40,40,30,30
