0, 20, 21, 21, 21, 22, 0, 0, 54, 0, 0, 54, 0, 0, 54, 0, 0, 54, 0, 0, 54, 0, 0, 54, 0, 0, 54, 0, 0, 15, 19, 39, 49, 13, 0, 0, 0, 0, 0, 0, 15, 11, 11, 11, 13, 0, 0, 0, 0, 0, 54, 0, 0, 54, 0, 0, 54, 0, 0, 54, 0, 0, 54, 0, 0, 54, 0, 0, 54, 0, 0, 15, 11, 11, 11, 13, 0, 0, 0, 0, 0, 0, 0, 0, 0, 0, 0, 0, 0, 0, 0, 0, 0, 0, 0, 0, 0, 0, 0, 0, 0, 15, 11, 11, 11, 13, 0,
0, 0, 0, 0, 0, 0, 0, 0, 54, 0, 0, 54, 0, 0, 54, 0, 0, 54, 0, 0, 54, 0, 0, 54, 0, 0, 54, 0, 0, 20, 21, 21, 21, 22, 0, 0, 0, 0, 0, 0, 15, 11, 11, 11, 13, 0, 0, 0, 0, 0, 54, 0, 0, 54, 0, 0, 54, 0, 0, 54, 0, 0, 54, 0, 0, 54, 0, 0, 54, 0, 0, 20, 21, 21, 21, 22, 0, 0, 0, 0, 0, 0, 0, 0, 0, 0, 0, 0, 0, 0, 0, 0, 0, 0, 0, 0, 0, 0, 0, 0, 0, 20, 21, 21, 21, 22, 0,
0, 0, 0, 0, 0, 0, 0, 0, 55, 0, 0, 54, 0, 0, 54, 0, 0, 54, 0, 0, 55, 0, 0, 54, 0, 0, 54, 0, 0, 0, 0, 0, 0, 0, 0, 0, 0, 0, 0, 0, 20, 21, 21, 21, 22, 0, 0, 0, 0, 0, 54, 0, 0, 55, 0, 0, 54, 0, 0, 55, 0, 0, 54, 0, 0, 55, 0, 0, 54, 0, 0, 0, 0, 0, 0, 0, 0, 0, 0, 0, 31, 32, 33, 0, 0, 0, 0, 0, 31, 32, 33, 0, 0, 0, 0, 0, 31, 32, 33, 0, 0, 0, 0, 0, 0, 0, 0,
0, 0, 0, 0, 0, 0, 0, 0, 0, 0, 0, 55, 0, 0, 54, 0, 0, 55, 0, 0, 0, 0, 0, 55, 0, 0, 54, 0, 0, 0, 0, 0, 0, 0, 0, 0, 0, 0, 0, 0, 0, 0, 0, 0, 0, 0, 0, 0, 0, 0, 55, 0, 0, 0, 0, 0, 55, 0, 0, 0, 0, 0, 55, 0, 0, 0, 0, 0, 55, 0, 0, 0, 0, 0, 0, 0, 0, 0, 38, 0, 0, 0, 0, 0, 31, 32, 33, 0, 0, 0, 0, 0, 31, 32, 33, 0, 0, 0, 0, 0, 0, 0, 0, 0, 0, 0, 0,
0, 0, 0, 0, 0, 1, 2, 0, 0, 0, 0, 0, 0, 0, 55, 0, 0, 0, 0, 0, 0, 0, 0, 0, 0, 0, 55, 0, 0, 0, 0, 0, 0, 0, 0, 1, 1, 2, 0, 0, 0, 0, 0, 0, 0, 0, 0, 0, 0, 0, 0, 0, 0, 0, 0, 0, 0, 0, 0, 0, 0, 0, 0, 0, 0, 0, 0, 0, 0, 0, 0, 0, 0, 0, 0, 0, 0, 38, 0, 38, 0, 0, 0, 0, 0, 0, 0, 0, 0, 0, 0, 0, 0, 0, 0, 0, 0, 0, 0, 0, 0, 0, 0, 0, 0, 2, 0,
0, 0, 0, 0, 56, 11, 23, 2, 0, 0, 0, 0, 0, 0, 0, 0, 0, 0, 0, 0, 38, 0, 38, 0, 0, 0, 0, 0, 0, 0, 0, 0, 0, 0, 56, 11, 11, 57, 2, 0, 0, 0, 0, 0, 0, 0, 0, 0, 0, 0, 0, 0, 0, 0, 0, 0, 0, 0, 0, 0, 0, 0, 0, 0, 0, 0, 0, 0, 0, 0, 0, 0, 0, 0, 0, 0, 38, 0, 0, 0, 38, 0, 6, 8, 0, 38, 0, 38, 0, 38, 0, 6, 38, 0, 38, 0, 38, 0, 38, 0, 0, 0, 0, 0, 56, 23, 2,
0, 0, 0, 56, 11, 11, 11, 23, 2, 0, 0, 0, 0, 6, 7, 8, 0, 38, 0, 38, 0, 38, 0, 6, 7, 8, 0, 6, 7, 8, 0, 0, 0, 56, 11, 11, 11, 11, 57, 2, 0, 0, 0, 0, 0, 1, 1, 1, 1, 2, 0, 38, 0, 38, 0, 38, 0, 38, 0, 38, 0, 38, 0, 38, 0, 38, 0, 38, 0, 38, 0, 38, 0, 38, 0, 38, 0, 0, 0, 0, 0, 38, 0, 0, 38, 0, 38, 0, 38, 0, 38, 0, 0, 38, 0, 38, 0, 38, 0, 38, 0, 0, 0, 11, 11, 11, 12,
0, 1, 56, 11, 11, 11, 11, 11, 23, 1, 1, 1, 1, 19, 39, 39, 39, 39, 39, 39, 39, 39, 39, 39, 39, 49, 1, 1, 1, 1, 1, 1, 56, 11, 11, 11, 11, 11, 11, 57, 1, 24, 24, 24, 56, 11, 11, 11, 11, 57, 19, 39, 39, 39, 39, 39, 39, 39, 39, 39, 39, 39, 39, 39, 39, 39, 39, 39, 39, 39, 39, 39, 39, 39, 39, 39, 39, 39, 39, 39, 39, 39, 39, 39, 39, 39, 39, 39, 39, 39, 39, 39, 39, 39, 39, 39, 39, 39, 39, 49, 1, 1, 56, 11, 11, 11, 12
