107
8
0,21,22,22,22,22,23,0,0,21,22,22,22,23,0,0,0,0,16,12,12,12,13,0,0,0,0,21,22,22,22,23,0,0,0,0,16,12,12,12,13,0,0,0,0,21,22,22,22,23,0,0,0,55,0,0,55,0,0,55,0,0,55,0,0,55,0,0,55,0,0,55,0,0,55,0,0,55,0,0,55,0,0,55,0,0,55,0,0,55,0,0,55,0,0,55,0,0,55,0,0,55,0,0,55,0,0,
0,0,0,0,0,0,0,0,0,0,0,0,0,0,0,0,0,0,21,22,22,22,23,0,0,0,0,0,0,0,0,0,0,0,0,0,21,22,22,22,23,0,0,0,0,0,0,0,0,0,0,0,0,55,0,0,55,0,0,55,0,0,55,0,0,55,0,0,55,0,0,55,0,0,55,0,0,55,0,0,55,0,0,55,0,0,55,0,0,55,0,0,55,0,0,55,0,0,55,0,0,55,0,0,55,0,0,
0,0,0,0,0,0,0,0,0,0,0,0,0,0,0,0,0,0,0,0,0,0,0,0,0,0,0,0,0,0,0,0,0,0,0,0,0,0,0,0,0,0,0,0,0,0,0,0,0,0,0,0,0,57,0,0,56,0,0,57,0,0,56,0,0,57,0,0,56,0,0,57,0,0,56,0,0,57,0,0,57,0,0,56,0,0,57,0,0,56,0,0,57,0,0,56,0,0,57,0,0,56,0,0,57,0,0,
0,0,0,0,0,0,0,0,0,0,0,0,0,0,0,0,0,0,0,0,0,0,0,0,0,0,0,0,0,0,0,0,0,0,0,0,0,0,0,0,0,0,0,0,0,0,0,0,0,0,0,0,0,56,0,0,55,0,0,56,0,0,55,0,0,56,0,0,55,0,0,56,0,0,55,0,0,56,0,0,56,0,0,55,0,0,56,0,0,55,0,0,56,0,0,55,0,0,56,0,0,55,0,0,56,0,0,
0,0,0,1,2,2,2,2,3,0,0,0,0,0,0,0,0,0,0,0,0,0,0,0,0,0,0,0,0,0,0,0,0,0,0,0,0,0,0,0,0,0,0,0,1,2,2,2,3,0,0,0,0,0,0,0,0,0,0,0,0,0,0,0,0,0,0,0,0,0,0,0,0,0,0,0,0,0,0,0,0,0,0,0,0,0,0,0,0,0,0,0,0,0,0,0,0,0,0,0,0,0,0,0,0,0,0,
0,0,1,57,12,12,12,12,58,3,0,0,0,0,0,0,0,0,39,0,39,0,39,0,39,0,39,0,39,0,39,0,39,0,39,0,39,0,0,0,0,0,0,1,57,12,12,12,13,0,0,0,0,0,0,0,0,0,1,2,3,0,0,0,1,2,3,0,0,0,1,2,3,0,0,0,1,2,3,0,0,0,0,0,0,0,1,3,0,0,0,0,0,0,0,0,0,0,0,0,0,0,0,0,0,0,0,
0,1,57,20,40,40,40,40,50,58,3,0,0,0,0,0,0,39,0,39,0,39,0,39,0,39,0,39,0,39,0,39,0,39,0,39,0,39,0,0,0,0,1,57,12,12,12,12,13,0,0,0,0,0,0,0,0,1,57,12,58,3,0,1,57,12,58,3,0,1,57,12,58,3,0,1,57,12,58,3,0,54,0,0,0,1,57,13,0,0,0,0,0,0,1,2,2,3,0,0,0,0,0,0,0,0,0,
1,57,12,12,12,12,12,12,12,12,58,2,2,2,2,2,2,20,40,40,40,40,40,40,40,40,40,40,40,40,40,40,40,40,40,40,40,50,2,2,2,2,57,12,12,12,12,12,58,2,2,2,2,2,2,2,2,57,12,12,12,58,2,57,12,12,12,58,2,57,12,12,12,58,2,57,12,12,12,58,2,28,2,2,2,57,12,58,2,2,2,2,2,2,57,12,12,58,2,2,2,2,2,2,2,2,2